9, 9, 9, 9, 9, 9, 9, 9, 9, 9, 9, 9, 9, 9, 9, 9, 9
9, 9, 9, 9, 9, 9, 9, 9, 9, 9, 9, 9, 9, 9, 9, 9, 9
9, 9, 11, 11, 11, 8, 8, 8, 9, 8, 8, 8, 11, 11, 11, 9, 9
9, 9, 11, 9, 11, 8, 8, 8, 9, 8, 8, 8, 11, 9, 11, 9, 9
9, 9, 11, 11, 9, 8, 8, 8, 9, 8, 8, 8, 9, 11, 11, 9, 9
9, 9, 8, 8, 8, 9, 8, 8, 8, 8, 8, 9, 8, 8, 8, 9, 9
9, 9, 8, 8, 8, 8, 8, 8, 9, 8, 8, 8, 8, 8, 8, 9, 9
9, 9, 9, 9, 8, 9, 8, 9, 9, 9, 8, 9, 8, 9, 9, 9, 9
9, 9, 8, 8, 8, 8, 8, 8, 9, 8, 8, 8, 8, 8, 8, 9, 9
9, 9, 8, 8, 8, 9, 8, 8, 8, 8, 8, 9, 8, 8, 8, 9, 9
9, 9, 11, 11, 9, 8, 8, 8, 9, 8, 8, 8, 9, 11, 11, 9, 9
9, 9, 11, 9, 11, 8, 8, 8, 9, 8, 8, 8, 11, 9, 11, 9, 9
9, 9, 11, 11, 11, 8, 8, 8, 9, 8, 8, 8, 11, 11, 11, 9, 9
9, 9, 9, 9, 9, 9, 9, 9, 9, 9, 9, 9, 9, 9, 9, 9, 9
9, 9, 9, 9, 9, 9, 9, 9, 9, 9, 9, 9, 9, 9, 9, 9, 9